# ----------二叠字	----------
两个火	炎 炏
两个土	圭
两个一	二
两个二	亖
两个山	岀 屾
两个口	吕 吅
两个田	畕
两个九	𠃙
两个飞	𠃧
两个戈	戔
两个兀	𠀘
两个𡥦	𡦪
两个巾	𢁝
两个左	𢀡
两个母	𣫯
两个来	𠐇
两个凡	𠘻
两个夕	多 𡖇
两个彐	𢑑
两个𢎘	𢎙
两个明	𣊧
两个朿	棘 棗
两个乂	爻
两个曰	昌
两个尸	𡰲
两个八	𠔁
两个而	𦓔
两个羊	𫅓
两个马	𩥋
两个卅	𢌽
两个巛	𡿭
两个比	𣬅
两个申	𤱓
两个余	𠎳
两个罒	𮊂
两个㐅	𬼆
两个金	鍂
两个木	林
两个水	沝
两个風	䬕
两个石	砳
两个日	昍
两个月	朋
两个目	䀠
两个白	㿟
两个百	皕
两个耳	聑
两个屮	艸
两个廿	𠦜
两个卄	卌
两个虫	䖵
两个魚	䲆 𩺰
两个牛	牪 𤘧
两个虎	虤
两个龍	龖
两个馬	騳
两个犬	㹜
两个人	从 仌
两个入	𠓜
两个习	羽
两个卪	𠨖
两个㔾	𠨎
两个几	𠘬
两个乙	𠃐
两个大	夶 㚐
两个夫	㚘
两个禾	秝
两个干	幵
两个井	㐩
两个斤	斦
两个片	㸞
两个牙	𤘆
两个炎	燚
两个弓	弜
两个永	𣴏
两个亦	𠅯
两个手	𢪒 抙
两个毛	㲎
两个王	玨
两个男	𤲶
两个女	奻 㚣
两个又	双 㕛
两个支	𢺸
两个隻	䨇
两个古	𠳬
两个吉	喆 𡔯
两个舌	𦧚
两个言	誩 𧨟
两个户	𢨯 𢨳
两个启	𢩙
两个來	㯤
两个桼	𣠬
两个旡	兓
两个歹	㱛
两个厶	厸 㕕
两个匕	比
两个幺	𢆶
两个玄	玆
两个心	𢗰
两个力	𠠴
两个欠	𣢐
两个子	孖
两个予	㐨
两个享	㝇
两个立	竝
两个音	䪭
两个竟	竸
两个竞	競
两个兄	㒭
两个見	覞
两个貝	賏
两个辛	辡
两个瓜	㼌
两个呆	槑
两个果	𣛕
两个鸟	𪅝
两个巢	𢀌
两个禺	𥝉
两个巿	𢂏
两个句	𠣪
两个奇	㚡
两个真	㒹
两个尹	𡱉
两个昔	𣊣
两个易	𣊷
两个臣	𦣦 𫇆
两个面	𩈳 𩈲
两个先	兟
两个老	䎜
两个示	祘
两个至	臸
两个生	甡
两个車	䡛
两个足	踀
两个區	𠥺
两个香	𩡐 𩡌
两个隹	雔
两个牟	𤚅
两个豕	豩
两个𠂢	𠃄
两个畐	㽬
两个㣇	㣈
两个邑	䣈
两个堯	㚁
两个秉	𥡝
两个倉	𠑐
两个東	㯥
两个善	𡆃
两个僉	𠑲
两个齒	𪙹
两个喜	囍
两个走	𧼂
两个止	𣥖 𣥕
两个昌	𣊫
两个串	𠁷
两个米	𥹫
两个束	𣗥 𬃷
两个隶	𨽼
两个不	𫠭
两个龙	𱍂
两个乞	𬼠
两个夋	𭐪
两个天	𭑈
# ----------二叠字2	----------
火火	炎 炏
土土	圭
一一	二
二二	亖
山山	岀 屾
口口	吕 吅
田田	畕
九九	𠃙
飞飞	𠃧
戈戈	戔
兀兀	𠀘
𡥦𡥦	𡦪
巾巾	𢁝
左左	𢀡
母母	𣫯
来来	𠐇
凡凡	𠘻
夕夕	多 𡖇
彐彐	𢑑
𢎘𢎘	𢎙
明明	𣊧
朿朿	棘 棗
乂乂	爻
曰曰	昌
尸尸	𡰲
八八	𠔁
而而	𦓔
羊羊	𫅓
马马	𩥋
卅卅	𢌽
巛巛	𡿭
比比	𣬅
申申	𤱓
余余	𠎳
罒罒	𮊂
㐅㐅	𬼆
金金	鍂
木木	林
水水	沝
風風	䬕
石石	砳
日日	昍
月月	朋
目目	䀠
白白	㿟
百百	皕
耳耳	聑
屮屮	艸
廿廿	𠦜
卄卄	卌
虫虫	䖵
魚魚	䲆 𩺰
牛牛	牪 𤘧
虎虎	虤
龍龍	龖
馬馬	騳
犬犬	㹜
人人	从 仌
入入	𠓜
习习	羽
卪卪	𠨖
㔾㔾	𠨎
几几	𠘬
乙乙	𠃐
大大	夶 㚐
夫夫	㚘
禾禾	秝
干干	幵
井井	㐩
斤斤	斦
片片	㸞
牙牙	𤘆
炎炎	燚
弓弓	弜
永永	𣴏
亦亦	𠅯
手手	𢪒 抙
毛毛	㲎
王王	玨
男男	𤲶
女女	奻 㚣
又又	双 㕛
支支	𢺸
隻隻	䨇
古古	𠳬
吉吉	喆 𡔯
舌舌	𦧚
言言	誩 𧨟
户户	𢨯 𢨳
启启	𢩙
來來	㯤
桼桼	𣠬
旡旡	兓
歹歹	㱛
厶厶	厸 㕕
匕匕	比
幺幺	𢆶
玄玄	玆
心心	𢗰
力力	𠠴
欠欠	𣢐
子子	孖
予予	㐨
享享	㝇
立立	竝
音音	䪭
竟竟	竸
竞竞	競
兄兄	㒭
見見	覞
貝貝	賏
辛辛	辡
瓜瓜	㼌
呆呆	槑
果果	𣛕
鸟鸟	𪅝
巢巢	𢀌
禺禺	𥝉
巿巿	𢂏
句句	𠣪
奇奇	㚡
真真	㒹
尹尹	𡱉
昔昔	𣊣
易易	𣊷
臣臣	𦣦 𫇆
面面	𩈳 𩈲
先先	兟
老老	䎜
示示	祘
至至	臸
生生	甡
車車	䡛
足足	踀
區區	𠥺
香香	𩡐 𩡌
隹隹	雔
牟牟	𤚅
豕豕	豩
𠂢𠂢	𠃄
畐畐	㽬
㣇㣇	㣈
邑邑	䣈
堯堯	㚁
秉秉	𥡝
倉倉	𠑐
東東	㯥
善善	𡆃
僉僉	𠑲
齒齒	𪙹
喜喜	囍
走走	𧼂
止止	𣥖 𣥕
昌昌	𣊫
串串	𠁷
米米	𥹫
束束	𣗥 𬃷
隶隶	𨽼
不不	𫠭
龙龙	𱍂
乞乞	𬼠
夋夋	𭐪
天天	𭑈
# ----------三叠字	----------
三个生	㽓
三个秦	䆐
三个若	䖃
三个雲	䨺
三个人	众 㐺
三个刀	刕
三个十	卉 𠦄
三个力	劦
三个原	厵
三个厶	厽
三个又	叒
三个口	品 𠱠
三个七	㐂
三个吉	嚞 𡕇
三个土	垚
三个士	壵
三个女	姦
三个子	孨 𡥦
三个小	尛 𡭯
三个心	惢
三个手	掱
三个日	晶 晿
三个木	森 𣓏
三个止	歮
三个毛	毳
三个水	淼 㴇
三个泉	灥
三个火	焱 㷋
三个牛	犇
三个犬	猋
三个田	畾
三个白	皛
三个目	瞐
三个直	矗
三个石	磊
三个羊	羴
三个耳	聶
三个舌	舙 𦧵
三个屮	芔
三个虫	蟲
三个言	譶 𧭛
三个贝	赑
三个車	轟
三个金	鑫
三个隹	雥 雦
三个雷	靐
三个風	飍
三个飛	飝
三个香	馫
三个马	骉 𩧢
三个魚	鱻
三个鹿	麤
三个龍	龘
三个个	𠁭
三个丶	𠁼
三个了	𠄕
三个介	𠌕
三个企	𠐰
三个舍	𠑰
三个圥	𠒶
三个光	𠓉
三个兔	𠓗
三个全	𠓾
三个𠙽	𠚛
三个𠧪	𠨋
三个㔾	𠨕
三个厡	𠫒
三个可	𠾳
三个因	𡈲
三个夏	𡖃
三个大	𡘙
三个天	𡙎
三个太	𡙒
三个𦉼	𡚤
三个宝	𡬏
三个宜	𡬐
三个客	𡬚
三个寒	𡬜
三个少	𡮏
三个山	𡷈
三个市	𢅈
三个文	𣁕
三个斗	𣁾
三个朿	𣝯
三个束	𣠆
三个林	𣡕
三个果	𣡗
三个欠	𣣓
三个𣥚	𣦴
三个爪	𤔙
三个妥	𤕇
三个用	𤰌
三个甲	𤳅
三个百	𤾩
三个盖	𥃣
三个県	𥍙
三个空	𥩌
三个亇	𥫮 𥫧
三个竹	𥴒
三个罒	𦋹
三个羗	𦏱
三个老	𦓈
三个月	𦜳
三个至	𦥏
三个興	𦧅
三个足	𨆬
三个㖖	𨑂
三个門	𨷮
三个面	𩉖
三个頁	𩖏
三个鳥	𪈼
三个男	𪟧
三个立	𫁪
三个九	𫡤
三个也	𫡩
三个加	𫦹
三个動	𫦿
三个千	𫧢
三个方	𬀉
三个朔	𬂚
三个玉	𬍼
三个申	𬏍
三个𡿨	巛
三个去	𠬑
三个弓	𢏝
三个䖝	𧔗
三个丿	彡
三个户	𢩕
三个瓜	𤬑
三个鸟	𪉓
三个米	𥼬
# ----------三叠字2	----------
生生生	㽓
秦秦秦	䆐
若若若	䖃
雲雲雲	䨺
人人人	众 㐺
刀刀刀	刕
十十十	卉 𠦄
力力力	劦
原原原	厵
厶厶厶	厽
又又又	叒
口口口	品 𠱠
七七七	㐂
吉吉吉	嚞 𡕇
土土土	垚
士士士	壵
女女女	姦
子子子	孨 𡥦
小小小	尛 𡭯
心心心	惢
手手手	掱
日日日	晶 晿
木木木	森 𣓏
止止止	歮
毛毛毛	毳
水水水	淼 㴇
泉泉泉	灥
火火火	焱 㷋
牛牛牛	犇
犬犬犬	猋
田田田	畾
白白白	皛
目目目	瞐
直直直	矗
石石石	磊
羊羊羊	羴
耳耳耳	聶
舌舌舌	舙 𦧵
屮屮屮	芔
虫虫虫	蟲
言言言	譶 𧭛
贝贝贝	赑
車車車	轟
金金金	鑫
隹隹隹	雥 雦
雷雷雷	靐
風風風	飍
飛飛飛	飝
香香香	馫
马马马	骉 𩧢
魚魚魚	鱻
鹿鹿鹿	麤
龍龍龍	龘
个个个	𠁭
丶丶丶	𠁼
了了了	𠄕
介介介	𠌕
企企企	𠐰
舍舍舍	𠑰
圥圥圥	𠒶
光光光	𠓉
兔兔兔	𠓗
全全全	𠓾
𠙽𠙽𠙽	𠚛
𠧪𠧪𠧪	𠨋
㔾㔾㔾	𠨕
厡厡厡	𠫒
可可可	𠾳
因因因	𡈲
夏夏夏	𡖃
大大大	𡘙
天天天	𡙎
太太太	𡙒
𦉼𦉼𦉼	𡚤
宝宝宝	𡬏
宜宜宜	𡬐
客客客	𡬚
寒寒寒	𡬜
少少少	𡮏
山山山	𡷈
市市市	𢅈
文文文	𣁕
斗斗斗	𣁾
朿朿朿	𣝯
束束束	𣠆
林林林	𣡕
果果果	𣡗
欠欠欠	𣣓
𣥚𣥚𣥚	𣦴
爪爪爪	𤔙
妥妥妥	𤕇
用用用	𤰌
甲甲甲	𤳅
百百百	𤾩
盖盖盖	𥃣
県県県	𥍙
空空空	𥩌
亇亇亇	𥫮 𥫧
竹竹竹	𥴒
罒罒罒	𦋹
羗羗羗	𦏱
老老老	𦓈
月月月	𦜳
至至至	𦥏
興興興	𦧅
足足足	𨆬
㖖㖖㖖	𨑂
門門門	𨷮
面面面	𩉖
頁頁頁	𩖏
鳥鳥鳥	𪈼
男男男	𪟧
立立立	𫁪
九九九	𫡤
也也也	𫡩
加加加	𫦹
動動動	𫦿
千千千	𫧢
方方方	𬀉
朔朔朔	𬂚
玉玉玉	𬍼
申申申	𬏍
𡿨𡿨𡿨	巛
去去去	𠬑
弓弓弓	𢏝
䖝䖝䖝	𧔗
丿丿丿	彡
户户户	𢩕
瓜瓜瓜	𤬑
鸟鸟鸟	𪉓
米米米	𥼬
# ----------四叠字	----------
四个乂	㸚
四个人	𠈌
四个厶	𠫬
四个又	叕
四个匕	𣬅
四个工	㠭
四个口	㗊
四个天	𡚌
四个小	𡮐
四个屮	茻
四个火	燚
四个牛	𤛭
四个魚	䲜
四个月	朤
四个日	𣊫
四个曰	𣊭
四个林	𣡽
四个水	㵘
四个石	𥗉
四个田	𤳳
四个甲	𤳵
四个且	𠁠
四个囚	𡈶
四个困	𡈹
四个竹	𥷹
四个老	𦓋
四个朿	𣡍
四个先	𠓙
四个金	𨰻
四个泉	𤆁
四个言	𧮦
四个門	𨷾
四个果	𣡾
四个春	𣌠
四个車	𨏿
四个風	𩙡
四个雷	䨻
四个雲	𩇔
四个興	𠔻
四个龍	𪚥
四个土	㙓
# ----------四叠字2	----------
乂乂乂乂	㸚
人人人人	𠈌
厶厶厶厶	𠫬
又又又又	叕
匕匕匕匕	𣬅
工工工工	㠭
口口口口	㗊
天天天天	𡚌
小小小小	𡮐
屮屮屮屮	茻
火火火火	燚
牛牛牛牛	𤛭
魚魚魚魚	䲜
月月月月	朤
日日日日	𣊫
曰曰曰曰	𣊭
林林林林	𣡽
水水水水	㵘
石石石石	𥗉
田田田田	𤳳
甲甲甲甲	𤳵
且且且且	𠁠
囚囚囚囚	𡈶
困困困困	𡈹
竹竹竹竹	𥷹
老老老老	𦓋
朿朿朿朿	𣡍
先先先先	𠓙
金金金金	𨰻
泉泉泉泉	𤆁
言言言言	𧮦
門門門門	𨷾
果果果果	𣡾
春春春春	𣌠
車車車車	𨏿
風風風風	𩙡
雷雷雷雷	䨻
雲雲雲雲	𩇔
興興興興	𠔻
龍龍龍龍	𪚥
土土土土	㙓