# ----------著名表演艺术家	----------
爱田飞鸟	あいだ飛鳥
爱乃娜美	愛乃なみ
安斋拉拉	安齋らら 宇都宫紫苑 宇都宮しをん RION
苍井空	蒼井そら
长谷川理穗	長谷川リホ
彩美旬果	あやみ旬果
春咲凉	春咲りょう
蒂亚	蒂亞 ティア
楪可怜	楪カレン
妃悠爱	妃悠愛 长泽杏奈 長澤杏奈
长泽杏奈	長澤杏奈 妃悠爱 妃悠愛
枫可怜	楓カレン 田中柠檬 田中レモン
枫花恋	楓カレン 田中柠檬 田中レモン
宫下华奈	宮下華奈
古川伊织	古川いおり
广濑里绪菜	広瀬りおな
河北春菜	河北はるな
吉川莲	吉川蓮
吉泽明步	吉沢明歩
铃村爱里	鈴村あいり
凉森玲梦	涼森れむ
林由奈	林ゆな
凛音桃花	凛音とうか
里美尤利娅	里美ゆりあ
芦名尤莉亚	芦名ユリア
美雪艾莉丝	美雪ありす
目黑惠	目黒めぐみ
明里䌷	明里つむぎ
七海蒂娜	七海ティナ
天海翼	天海つばさ
桃谷绘里香	桃谷エリカ
辻井穗乃果	辻井ほのか
桥本有菜	橋本ありな 新有菜 新ありな
深田咏美	深田えいみ
三上悠亚	三上悠亜
桃乃木香奈	桃乃木かな
武藤绫香	武藤あやか
希岛爱理	希島あいり
夏希栗	夏希まろん
希崎杰西卡	希崎ジェシカ
小泽玛利亚	小澤マリア
小岛南	小島みなみ
相泽南	相沢みなみ
新有菜	新ありな 桥本有菜 橋本ありな
星宫一花	星宮一花
星野景子	ほしの景子
星野娜美	星野ナミ
筱田步美	篠田あゆみ
柚木蒂娜	柚木ティナ
有贺由爱	有賀ゆあ
乙白沙也加	乙白さやか
樱井步	桜井あゆ
樱井彩	桜井彩
樱空桃	桜空もも
宇都宫紫苑	宇都宮しをん 安斋拉拉 安齋らら RION
一之濑亚美莉	一ノ瀬アメリ
樱木凛	桜木凛
园田美樱	園田みおん
永野司	永野つかさ
早川濑里奈	早川瀬里奈
椎名由奈	椎名ゆな
竹内有纪	竹内有紀
三宫椿	三宮つばき
蓝芽水月	藍芽みずき
星野明	星野あかり
莲实克蕾儿	蓮実クレア
香苗玲音	香苗レノン
有原步美	有原あゆみ
美谷朱里	美谷あかり
水川堇	水川スミレ 水稀美里 水稀みり 百多えみり
水稀美里	水稀みり 水川堇 水川スミレ 百多えみり
小宵虎南	小宵こなん
新村晶	新村あかり
森泽佳奈	森沢かな 饭冈佳奈子 飯岡かなこ
饭冈佳奈子	飯岡かなこ 森泽佳奈 森沢かな
朝日奈花恋	朝日奈かれん
高桥圣子	高橋しょう子
西宫梦	西宮ゆめ
藤森里穗	藤森里穂
木村穗乃香	木村穂乃香
神宫寺奈绪	神宮寺ナオ
水卜樱	水卜さくら
爱音麻里亚	愛音まりあ
良音荠	良音なずな
本庄铃	本庄鈴
明日花绮罗	明日花キララ
大桥未久	大橋未久
濑名光莉	瀬名きらり
栗山莉绪	栗山莉緒
纱纱原百合	紗々原ゆり
堀北湾	堀北わん
冲田杏梨	沖田杏梨
天使萌	天使もえ
西条琉璃	西條るり
君岛美绪	君島みお
波多野结衣	波多野結衣
松下纱荣子	松下紗栄子
山手梨爱	山手梨愛
濑亚美莉	瀬アメリ
望月理沙	望月りさ
上原瑞穗	上原瑞穂
岬奈奈美	岬ななみ
神菜美舞	神菜美まい
白桃花	白桃はな
栗宫双叶	栗宮ふたば
飞鸟里伊奈	飛鳥りいな
天音真比奈	天音まひな
凰香奈芽	凰かなめ
翼舞	つばさ舞
神木丽	神木麗
小花暖	小花のん
山口叶琉	山口葉瑠
赤目丽兰	赤目レイラン
天马唯	天馬ゆい
七森莉莉	七ツ森りり
田中柠檬	田中レモン 枫可怜 枫花恋 楓カレン
小凑四叶	小湊よつ葉
爱宝铃	愛宝すず
爱弓凉	愛弓りょう
爱世梦罗	愛世くらら
爱田奈奈	愛田奈々
爱原沙耶	爱原さえ
爱泽有纱	愛沢有紗
安达夕莉	安達夕莉
庵姬花	庵ひめか
安美波	安みなみ
安位薰	安位カヲル
奥井枫	奥井楓
八挂海	八掛うみ
八木奈奈	八木奈々
白坂美杏	白坂みあん
白川柚子	白川ゆず
白峰美羽	白峰ミウ
百濑飞鸟	百瀬あすか
柏木小夏	柏木こなつ
白木优子	白木優子
白崎彩叶	白崎いろは
百永纱里奈	百永さりな
坂道美琉	坂道みる miru
坂井成羽	坂井なるは
宝田萌奈美	宝田もなみ
北川爱莉香	北川エリカ
北川杏树	北川杏樹
北川柚子	北川ゆず
本乡爱	本郷愛 二阶堂梦 二階堂夢
本真友里	本真ゆり
本庄优花	本庄優花
并木优	並木優
仓本堇	倉本すみれ
仓多真央	倉多まお
朝比奈七濑	朝比奈ななせ
朝日铃	朝日りん
朝日奈可怜	朝日奈かれん
朝田日葵	朝田ひまり
辰巳唯	辰巳ゆい
初川南	初川みなみ
川北里菜	川北りな
川北明沙	川北メイサ
川村真矢	川村まや
川越唯	川越ゆい
椎名空	椎名そら
吹石玲奈	吹石れな
春菜华	春菜はな
椿莉香	椿りか
大槻响	大槻ひびき
稻场流花	稲場るか
稻川夏目	稲川なつめ 黑川堇 黒川すみれ
稻森美忧	稲森美憂
冬爱琴音	冬愛ことね
东凛	東凛
东条夏	東條なつ
冬月枫	冬月かえで
东云美玲	東雲みれい
二宫光	二宮ひかり
二阶堂梦	二階堂夢 本乡爱 本郷愛
儿玉玲奈	児玉れな
枫芙爱	楓ふうあ
逢见梨花	逢見リカ
风间由美	風間ゆみ
逢月日葵	逢月ひまり
富安玲于奈	冨安れおな
绀野光	紺野ひかる
圆井萌华	円井萌華
根尾明里	根尾あかり
宫城理惠	宮城りえ
宫岛芽衣	宮島めい
工藤拉拉	工藤ララ
工藤美纱	工藤美紗
宫西光	宮西ひかる
宫下玲奈	宮下玲奈
宫泽千春	宮沢ちはる
广濑光希	広瀬みつき
广濑莲	広瀬蓮
河北朝阳	河北あさひ
河合明日菜	河合あすな
河南实里	河南実里
黑川堇	黒川すみれ 稻川夏目 稲川なつめ
黑木一香	黒木いちか
横宫七海	横宮七海
胡桃樱	胡桃さくら
花狩舞	花狩まい
花泽日葵	花沢ひまり 木下日葵 木下ひまり
皇柚子	皇ゆず
吉川爱美	吉川あいみ
吉高宁宁	吉高寧々
吉根柚莉爱	吉根ゆりあ
吉良铃	吉良りん
迹美朱里	跡美しゅり
姬咲华	姫咲はな
吉永好美	吉永このみ
佳苗琉花	佳苗るか
架乃由罗	架乃ゆら
加藤绫野	加藤あやの
岬樱	岬さくら
笕纯	筧ジュン 鹫尾芽衣 鷲尾めい
菅野松雪	菅野さゆき
结城莉乃	結城りの
结城美佐	結城みさ
皆濑明里	皆瀬あかり
皆月光	皆月ひかる
九条满	九条みちる
鹫尾芽衣	鷲尾めい 笕纯 筧ジュン
九野雏乃	九野ひなの
堀咲莉娅	堀咲りあ
堀泽茉由	堀沢茉由
葵司	葵つかさ
葵伊吹	葵いぶき 翼葵 翼あおい
濑名步	瀬名あゆむ
濑名光	瀬名ひかり
濑田一花	瀬田一花
蕾	つぼみ
立花美凉	立花美涼
凉宫琴音	涼宮琴音
绫濑心	綾瀬こころ
铃木心春	鈴木心春
铃音铃	鈴音りん
铃原爱蜜莉	铃原エミリ
铃原美兰	鈴原みらん
瑠川里菜	瑠川リナ
泷川花音	瀧川花音
萝琳花恋	ローレン花恋
麻仓优	麻倉憂
美波那美	美波なみ
美波桃	美波もも
美雏	みひな 永井美雏 永井みひな
美里有纱	美里有紗
美乃雀	美乃すずめ
美神葵	美神あおい
美咲结衣	美咲結衣
美园和花	美園和花
美之岛惠理	美ノ嶋めぐり
美竹铃	美竹すず
梦见露	夢見るぅ
梦乃爱华	夢乃あいか
弥生美月	弥生みづき
明日见未来	明日見未来
末广纯	末広純
木下凛凛子	木下凛々子
木下日葵	木下ひまり 花泽日葵 花沢ひまり
南条一香	南条いちか
七海雏	七海ひな
崎惠梨香	尾崎えりか
七濑爱丽丝	七瀬アリス
七濑伊织	七瀬いおり
七泽美亚	七沢みあ
前田香织	前田かおり
青空光	青空ひかり
丘惠理奈	丘えりな
仁科百华	仁科百華
日向枫	日向かえで
日向由良	日向ゆら
日向真凛	ひなたまりん
荣川乃亚	栄川乃亜
宍户里帆	宍戸里帆
若宫穗乃	若宮穂乃
三舩美铃	三舩みすず
三浦步美	三浦歩美
三田樱	三田サクラ
三尾惠	三尾めぐ
三叶千春	三葉ちはる
森川玉绪	森川玉緒
纱仓真菜	紗倉まな
沙月芽衣	さつき芽衣
上坂芽衣	上坂めい
上羽绚	上羽絢
上原亚衣	上原亜衣
涩谷美希	渋谷美希
神纳花	神納花
深田结梨	深田結梨
神雪	神ユキ
市川雅美	市川まさみ
似鸟日菜	似鳥日菜
时田亚美	時田亜美
枢木葵	枢木あおい
水岛津实	水嶋あずみ
水户香奈	水戸かな
水无濑优夏	みなせ優夏
水野朝阳	水野朝陽
水原美园	水原みその
水泽乃乃	水沢のの
四宫爱丽丝	四宮ありす
松本菜奈实	松本菜奈実
松本一香	松本いちか
松冈千菜	松岡ちな
松井优子	松井優子
穗高结花	穂高結花
穗高有纪	穂高ゆうき
穗花爱里	穂花あいり
桃尻香名芽	桃尻かなめ
桃濑友梨奈	桃瀬友梨奈
桃园怜奈	桃園怜奈
藤环奈	藤かんな
藤井爱纱	藤井あいさ
藤井一夜	藤井いよな
藤浦惠	藤浦めぐ
天宫花南	天宮花南
天晴乃爱	天晴乃愛
天使亚梦	あまつか亜夢
天音唯	天音ゆい
田中宁宁	田中ねね
桐谷茉莉	 桐谷まつり
未步奈奈	未歩なな
唯井真寻	唯井まひろ
五十岚夏	五十嵐なつ
舞原圣	舞原聖
西宫好美	西宮このみ
汐世	有栖花绯 有栖花あか
希咲艾玛	希咲エマ
希咲亚里子	希咲アリス
西野星夏	西野セイナ
西元明沙	西元めいさ
希志爱野	希志あいの
夏木玲	夏木りん
夏目响	夏目響
香澄果穗	かすみ果穂
香澄莉子	香澄りこ
香水纯	香水じゅん
相泽莉娜	相澤リナ
小仓七海	小倉七海
小仓由菜	小倉由菜
小川阿佐美	小川あさ美
小岛纯名	小嶋ジュンナ
筱惠美	篠めぐみ
小栗美优	小栗みゆ
小梅惠奈	小梅えな
小泉日向	小泉ひなた
筱田优	篠田ゆう
新村朱里	新村あかり
新井里真	新井リマ
星奈爱	星奈あい
芽森滴	芽森しずく
叶爱	叶愛
叶风优莉亚	葉風ゆりあ
叶月凉子	葉月涼子
乙爱丽丝	乙アリス
伊东千奈美	伊東ちなみ
一宫希帆	一宮希帆
伊贺真子	伊賀まこ
翼葵	翼あおい 葵伊吹 葵いぶき
一乃葵	一乃あおい
伊藤沙也香	うんぱい
伊藤圣夏	伊藤聖夏
伊织雏乃	伊織ひなの
一之濑梓	一ノ瀬梓
伊织羽音	伊織羽音
樱井艾蜜莉	桜井エミリ
樱木优希音	桜木優希音
樱心美	桜ここみ
樱由罗	さくらゆら
永井玛利亚	永井マリア
永濑唯	永瀬ゆい
由爱可奈	由愛可奈
有冈美羽	有岡みう
优梨舞奈	優梨まいな
有栖花绯	有栖花あか 汐世
悠纱有朱	悠紗ありす
柚月亚衣	柚月あい
雨宫琴音	雨宮琴音
玉名美良	玉名みら
与田樱	与田さくら
羽咲美晴	羽咲みはる
月见伊织	月見伊織
月乃雏	月乃ひな
月乃露娜	月乃ルナ
月野霞	月野かすみ
早野诗	はやのうた
早乙女露依	早乙女ルイ
斋藤亚美里	斎藤あみり
长泽梓	長澤あずさ
真白爱梨	真白愛梨
真白希实	真白希実
知花梅莎	知花メイサ
织田真子	織田真子
仲村美羽	仲村みう
柊木枫	柊木楓
中山文香	中山ふみか
渚光希	渚みつき
竹内爱	竹内あい
竹内乃爱	竹内乃愛
竹田梦	竹田ゆめ
朱音唯	朱音ゆい
梓光莉	梓ヒカリ
佐山爱	佐山愛
佐佐木明希	佐々木あき
松本梨穗	松本梨穂
佐野由真	佐野ゆま
天川空	天川そら
宫濑里子	宮瀬リコ
梦实香苗	夢実かなえ
劳伦花恋	ローレン花恋
美咲佳奈	美咲かんな
春阳萌花	春陽モカ